"Letra","total","solo","acomp","1 amigo","2 amigos","Nucleo","Redox","deam/isom","Corr Fossil","Decay"
" A     ","    17 ","   12 ","     5 ","      5 ","      0 ",1,1,1,-2,1
" C     ","   105 ","   42 ","    63 ","     57 ","      6 ",14,15,1,0,30
" D     ","    22 ","   15 ","     7 ","      7 ","      0 ",2,1,6,0,9
" E     ","    22 ","   15 ","     7 ","      7 ","      0 ",2,2,1,0,5
" F     ","    10 ","    5 ","     5 ","      5 ","      0 ",1,2,1,0,4
" G     ","    47 ","   18 ","    29 ","     29 ","      0 ",1,1,1,-2,1
" H     ","    20 ","   15 ","     5 ","      5 ","      0 ",7,6,1,0,14
" I     ","    15 ","   11 ","     4 ","      4 ","      0 ",1,1,1,-1,2
" K     ","    54 ","   33 ","    21 ","     21 ","      0 ",5,2,1,0,8
" L     ","    11 ","    8 ","     3 ","      3 ","      0 ",1,1,1,-1,2
" M     ","    18 ","   11 ","     7 ","      5 ","      2 ",2,10,1,0,13
" N     ","    29 ","   14 ","    15 ","     15 ","      0 ",2,1,7,0,10
" P     ","    17 ","   11 ","     6 ","      6 ","      0 ",1,2,1,-1,3
" Q     ","    14 ","    9 ","     5 ","      5 ","      0 ",2,1,5,0,8
" R     ","    24 ","   19 ","     5 ","      5 ","      0 ",1,2,1,0,4
" S     ","    55 ","   31 ","    24 ","     18 ","      6 ",3,2,1,0,6
" T     ","    38 ","   22 ","    16 ","     16 ","      0 ",3,2,1,0,6
" V     ","    11 ","    7 ","     4 ","      4 ","      0 ",1,1,1,-1,2
" W     ","    19 ","   12 ","     7 ","      5 ","      2 ",2,9,1,0,12
" Y     ","    35 ","   21 ","    14 ","     12 ","      2 ",3,3,1,0,7